CURSO;DISCIPLINA;QUANTIDADE DE TURMAS;TOTAL DE VAGAS;QUANTIDADE DE SOLICITAÇÕES;QUANTIDADE DE MATRÍCULAS DEFERIDAS;QUANTIDADE DE MATRÍCULAS INDEFERIDAS
BACHARELADO EM BIOTECNOLOGIA;NHZ6007-18;1;50;36;36;0
BACHARELADO EM BIOTECNOLOGIA;NHZ6010-18;1;30;15;15;0
BACHARELADO EM BIOTECNOLOGIA;NHZ6016-18;1;30;26;26;0
BACHARELADO EM CIÊNCIA DA COMPUTAÇÃO;ESZA019-17;1;10;30;10;20
BACHARELADO EM CIÊNCIA DA COMPUTAÇÃO;MCTA002-17;5;216;181;181;0
BACHARELADO EM CIÊNCIA DA COMPUTAÇÃO;MCTA003-17;1;10;20;10;10
BACHARELADO EM CIÊNCIA DA COMPUTAÇÃO;MCTA004-17;2;193;207;190;17
BACHARELADO EM CIÊNCIA DA COMPUTAÇÃO;MCTA008-17;4;163;161;146;15
BACHARELADO EM CIÊNCIA DA COMPUTAÇÃO;MCTA014-15;3;255;270;236;34
BACHARELADO EM CIÊNCIA DA COMPUTAÇÃO;MCTA017-17;2;165;146;146;0
BACHARELADO EM CIÊNCIA DA COMPUTAÇÃO;MCTA027-17;3;214;188;188;0
BACHARELADO EM CIÊNCIA DA COMPUTAÇÃO;MCTA028-15;19;785;749;617;132
BACHARELADO EM CIÊNCIA DA COMPUTAÇÃO;MCTA037-17;7;286;401;-53;454
BACHARELADO EM CIÊNCIA DA COMPUTAÇÃO;MCZA008-17;1;10;27;10;17
BACHARELADO EM CIÊNCIA DA COMPUTAÇÃO;MCZA015-13;1;48;67;48;19
BACHARELADO EM CIÊNCIA DA COMPUTAÇÃO;MCZA018-17;1;48;14;14;0
BACHARELADO EM CIÊNCIA DA COMPUTAÇÃO;MCZA019-17;1;48;105;48;57
BACHARELADO EM CIÊNCIA DA COMPUTAÇÃO;MCZA042-17;1;40;22;22;0
BACHARELADO EM CIÊNCIA DA COMPUTAÇÃO;MCZA047-17;2;10;6;5;1
BACHARELADO EM CIÊNCIA DA COMPUTAÇÃO;MCZA049-17;1;40;64;40;24
BACHARELADO EM CIÊNCIA DA COMPUTAÇÃO;MCZA050-17;1;48;16;16;0
BACHARELADO EM CIÊNCIA DA COMPUTAÇÃO;MCZB015-13;1;74;81;74;7
BACHARELADO EM CIÊNCIA DA COMPUTAÇÃO;NHI2049-13;6;535;490;490;0
BACHARELADO EM CIÊNCIA E TECNOLOGIA;BCJ0204-15;75;2376;2343;2040;303
BACHARELADO EM CIÊNCIA E TECNOLOGIA;BCK0103-15;18;1260;1132;1074;58
BACHARELADO EM CIÊNCIA E TECNOLOGIA;BCL0306-15;18;1720;1414;1414;0
BACHARELADO EM CIÊNCIA E TECNOLOGIA;BCL0308-15;39;1050;1112;565;547
BACHARELADO EM CIÊNCIA E TECNOLOGIA;BCM0504-15;18;1719;1424;1424;0
BACHARELADO EM CIÊNCIA E TECNOLOGIA;BCM0505-15;4;212;206;206;0
BACHARELADO EM CIÊNCIA E TECNOLOGIA;BCM0506-15;3;298;249;236;13
BACHARELADO EM CIÊNCIA E TECNOLOGIA;BCN0402-15;26;2333;2129;2108;21
BACHARELADO EM CIÊNCIA E TECNOLOGIA;BCN0404-15;23;2040;1855;1815;40
BACHARELADO EM CIÊNCIA E TECNOLOGIA;BCN0405-15;6;541;241;241;0
BACHARELADO EM CIÊNCIA E TECNOLOGIA;BIJ0207-15;3;270;139;139;0
BACHARELADO EM CIÊNCIA E TECNOLOGIA;BIK0102-15;4;360;154;154;0
BACHARELADO EM CIÊNCIA E TECNOLOGIA;BIL0304-15;4;360;110;110;0
BACHARELADO EM CIÊNCIA E TECNOLOGIA;BIN0406-15;8;630;410;410;0
BACHARELADO EM CIÊNCIA E TECNOLOGIA;BIQ0602-15;10;860;599;599;0
BACHARELADO EM CIÊNCIA E TECNOLOGIA;BIR0004-15;12;1003;749;733;16
BACHARELADO EM CIÊNCIA E TECNOLOGIA;BIR0603-15;6;597;431;423;8
BACHARELADO EM CIÊNCIA E TECNOLOGIA;BIS0003-15;12;1111;825;817;8
BACHARELADO EM CIÊNCIA E TECNOLOGIA;BIS0005-15;6;206;239;206;33
BACHARELADO EM CIÊNCIAS BIOLÓGICAS;NHT1030-15;2;61;51;51;0
BACHARELADO EM CIÊNCIAS BIOLÓGICAS;NHT1048-15;2;60;68;57;11
BACHARELADO EM CIÊNCIAS BIOLÓGICAS;NHT1049-15;2;60;8;8;0
BACHARELADO EM CIÊNCIAS BIOLÓGICAS;NHT1053-15;4;120;102;109;-7
BACHARELADO EM CIÊNCIAS BIOLÓGICAS;NHT1057-15;2;60;47;47;0
BACHARELADO EM CIÊNCIAS BIOLÓGICAS;NHT1060-15;2;60;35;35;0
BACHARELADO EM CIÊNCIAS BIOLÓGICAS;NHT1064-15;2;60;24;24;0
BACHARELADO EM CIÊNCIAS BIOLÓGICAS;NHT1068-15;2;60;37;37;0
BACHARELADO EM CIÊNCIAS BIOLÓGICAS;NHT1070-15;2;60;25;25;0
BACHARELADO EM CIÊNCIAS BIOLÓGICAS;NHT1093-16;2;30;9;9;0
BACHARELADO EM CIÊNCIAS BIOLÓGICAS;NHZ1014-15;1;30;17;17;0
BACHARELADO EM CIÊNCIAS BIOLÓGICAS;NHZ1015-15;1;30;7;7;0
BACHARELADO EM CIÊNCIAS BIOLÓGICAS;NHZ1024-15;1;30;36;30;6
BACHARELADO EM CIÊNCIAS BIOLÓGICAS;NHZ1026-15;1;0;2;0;2
BACHARELADO EM CIÊNCIAS BIOLÓGICAS;NHZ1037-15;2;55;41;41;0
BACHARELADO EM CIÊNCIAS BIOLÓGICAS;NHZ1050-15;1;30;13;13;0
BACHARELADO EM CIÊNCIAS BIOLÓGICAS;NHZ1079-15;1;0;1;0;1
BACHARELADO EM CIÊNCIAS E HUMANIDADES;BHO0001-15;4;454;484;449;35
BACHARELADO EM CIÊNCIAS E HUMANIDADES;BHO1101-15;4;442;489;422;67
BACHARELADO EM CIÊNCIAS E HUMANIDADES;BHO1335-15;4;449;436;412;24
BACHARELADO EM CIÊNCIAS E HUMANIDADES;BHP0001-15;2;182;185;150;35
BACHARELADO EM CIÊNCIAS E HUMANIDADES;BHP0202-15;4;459;437;426;11
BACHARELADO EM CIÊNCIAS E HUMANIDADES;BHQ0002-15;2;188;156;143;13
BACHARELADO EM CIÊNCIAS E HUMANIDADES;BHQ0301-15;2;180;162;147;15
BACHARELADO EM CIÊNCIAS E HUMANIDADES;BHS0001-15;3;135;179;131;48
BACHARELADO EM CIÊNCIAS ECONÔMICAS;ESHC002-17;2;180;267;180;87
BACHARELADO EM CIÊNCIAS ECONÔMICAS;ESHC008-17;2;180;199;165;34
BACHARELADO EM CIÊNCIAS ECONÔMICAS;ESHC014-17;2;123;72;72;0
BACHARELADO EM CIÊNCIAS ECONÔMICAS;ESHC020-17;2;180;281;180;101
BACHARELADO EM CIÊNCIAS ECONÔMICAS;ESHC026-17;2;150;143;126;17
BACHARELADO EM CIÊNCIAS ECONÔMICAS;ESHC028-17;2;180;259;180;79
BACHARELADO EM CIÊNCIAS ECONÔMICAS;ESHC030-17;2;180;182;148;34
BACHARELADO EM CIÊNCIAS ECONÔMICAS;ESHC031-17;2;182;129;129;0
BACHARELADO EM CIÊNCIAS ECONÔMICAS;ESHC032-17;2;150;203;140;63
BACHARELADO EM CIÊNCIAS ECONÔMICAS;ESHC034-17;2;180;116;116;0
BACHARELADO EM CIÊNCIAS ECONÔMICAS;ESHC035-17;5;176;167;110;57
BACHARELADO EM CIÊNCIAS ECONÔMICAS;ESHC037-17;1;42;0;0;0
BACHARELADO EM CIÊNCIAS ECONÔMICAS;ESHC039-17;2;180;92;92;0
BACHARELADO EM CIÊNCIAS ECONÔMICAS;ESZC001-17;2;42;7;6;1
BACHARELADO EM CIÊNCIAS ECONÔMICAS;ESZC013-17;1;90;17;17;0
BACHARELADO EM CIÊNCIAS ECONÔMICAS;ESZC020-17;2;180;180;164;16
BACHARELADO EM CIÊNCIAS ECONÔMICAS;ESZC029-17;1;90;13;13;0
BACHARELADO EM FILOSOFIA;NHH2009-13;2;80;40;40;0
BACHARELADO EM FILOSOFIA;NHH2016-13;2;80;26;26;0
BACHARELADO EM FILOSOFIA;NHH2028-13;2;80;60;60;0
BACHARELADO EM FILOSOFIA;NHH2032-13;2;80;28;28;0
BACHARELADO EM FILOSOFIA;NHH2034-13;2;80;43;43;0
BACHARELADO EM FILOSOFIA;NHH2041-13;2;80;23;23;0
BACHARELADO EM FILOSOFIA;NHH2065-13;2;80;15;49;-34
BACHARELADO EM FILOSOFIA;NHH2072-13;2;80;21;21;0
BACHARELADO EM FILOSOFIA;NHZ2037-11;1;30;11;11;0
BACHARELADO EM FILOSOFIA;NHZ2069-11;1;30;6;6;0
BACHARELADO EM FILOSOFIA;NHZ2071-11;1;30;8;8;0
BACHARELADO EM FILOSOFIA;NHZ2075-11;1;30;8;8;0
BACHARELADO EM FÍSICA;NHT3012-15;3;85;75;63;12
BACHARELADO EM FÍSICA;NHT3028-15;2;60;45;45;0
BACHARELADO EM FÍSICA;NHT3067-15;2;60;23;23;0
BACHARELADO EM FÍSICA;NHT3071-15;2;58;34;34;0
BACHARELADO EM FÍSICA;NHT3072-15;2;60;33;33;0
BACHARELADO EM FÍSICA;NHT3089-15;1;30;9;9;0
BACHARELADO EM FÍSICA;NHZ2024-11;1;40;9;9;0
BACHARELADO EM FÍSICA;NHZ3002-15;1;40;5;5;0
BACHARELADO EM FÍSICA;NHZ3020-15;1;40;9;9;0
BACHARELADO EM FÍSICA;NHZ3023-15;1;30;20;20;0
BACHARELADO EM FÍSICA;NHZ3024-15;1;40;7;7;0
BACHARELADO EM FÍSICA;NHZ3026-15;1;40;11;11;0
BACHARELADO EM FÍSICA;NHZ3058-15;1;30;9;9;0
BACHARELADO EM FÍSICA;NHZ3075-15;1;40;3;3;0
BACHARELADO EM FÍSICA;NHZ3082-15;1;30;2;30;-28
BACHARELADO EM FÍSICA;NHZ3086-15;7;245;199;175;24
BACHARELADO EM MATEMÁTICA;MCTB003-17;2;90;32;32;0
BACHARELADO EM MATEMÁTICA;MCTB004-17;2;70;13;13;0
BACHARELADO EM MATEMÁTICA;MCTB005-13;2;90;41;41;0
BACHARELADO EM MATEMÁTICA;MCTB008-17;2;90;50;50;0
BACHARELADO EM MATEMÁTICA;MCTB011-17;2;90;9;9;0
BACHARELADO EM MATEMÁTICA;MCTB018-17;2;90;44;44;0
BACHARELADO EM MATEMÁTICA;MCTB021-17;2;90;15;15;0
BACHARELADO EM MATEMÁTICA;MCTB024-13;1;45;3;3;0
BACHARELADO EM MATEMÁTICA;MCTB025-13;1;45;6;6;0
BACHARELADO EM MATEMÁTICA;MCTB027-13;1;45;1;1;0
BACHARELADO EM MATEMÁTICA;MCZB018-13;1;60;18;18;0
BACHARELADO EM MATEMÁTICA;MCZB035-17;2;75;25;25;0
BACHARELADO EM MATEMÁTICA;MCZB038-17;1;45;6;6;0
BACHARELADO EM NEUROCIÊNCIA;MCTC002-15;3;200;171;171;0
BACHARELADO EM NEUROCIÊNCIA;MCTC011-15;3;204;163;163;0
BACHARELADO EM NEUROCIÊNCIA;MCTC022-15;2;85;73;73;0
BACHARELADO EM NEUROCIÊNCIA;MCTC024-15;2;80;49;49;0
BACHARELADO EM NEUROCIÊNCIA;MCZC002-15;2;82;48;48;0
BACHARELADO EM NEUROCIÊNCIA;MCZC004-15;2;80;33;33;0
BACHARELADO EM NEUROCIÊNCIA;MCZC010-15;2;95;94;94;0
BACHARELADO EM NEUROCIÊNCIA;MCZC016-15;2;125;69;69;0
BACHARELADO EM NEUROCIÊNCIA;NHT1058-15;2;70;64;57;7
BACHARELADO EM PLANEJAMENTO TERRITORIAL;ESHT001-17;2;76;39;39;0
BACHARELADO EM PLANEJAMENTO TERRITORIAL;ESHT003-17;2;79;43;43;0
BACHARELADO EM PLANEJAMENTO TERRITORIAL;ESHT005-17;2;104;89;89;0
BACHARELADO EM PLANEJAMENTO TERRITORIAL;ESHT007-17;2;98;84;76;8
BACHARELADO EM PLANEJAMENTO TERRITORIAL;ESHT010-17;2;76;78;67;11
BACHARELADO EM PLANEJAMENTO TERRITORIAL;ESHT013-17;2;60;24;24;0
BACHARELADO EM PLANEJAMENTO TERRITORIAL;ESHT016-17;2;76;20;20;0
BACHARELADO EM PLANEJAMENTO TERRITORIAL;ESHT019-17;2;76;30;30;0
BACHARELADO EM PLANEJAMENTO TERRITORIAL;ESHT021-17;2;68;53;48;5
BACHARELADO EM PLANEJAMENTO TERRITORIAL;ESHT023-17;2;83;83;79;4
BACHARELADO EM PLANEJAMENTO TERRITORIAL;ESZT014-17;1;50;46;46;0
BACHARELADO EM PLANEJAMENTO TERRITORIAL;ESZT022-17;1;38;8;8;0
BACHARELADO EM POLÍTICAS PÚBLICAS;ESHP004-13;2;120;157;107;50
BACHARELADO EM POLÍTICAS PÚBLICAS;ESHP007-13;2;84;65;65;0
BACHARELADO EM POLÍTICAS PÚBLICAS;ESHP013-13;2;120;92;92;0
BACHARELADO EM POLÍTICAS PÚBLICAS;ESHP014-13;2;100;96;82;14
BACHARELADO EM POLÍTICAS PÚBLICAS;ESHP018-14;2;80;50;50;0
BACHARELADO EM POLÍTICAS PÚBLICAS;ESHP019-13;2;150;157;121;36
BACHARELADO EM POLÍTICAS PÚBLICAS;ESHP022-14;2;125;161;125;36
BACHARELADO EM POLÍTICAS PÚBLICAS;ESHP026-14;2;80;56;54;2
BACHARELADO EM POLÍTICAS PÚBLICAS;ESHP027-14;2;80;49;49;0
BACHARELADO EM POLÍTICAS PÚBLICAS;ESZP022-13;1;42;30;30;0
BACHARELADO EM POLÍTICAS PÚBLICAS;ESZP034-14;1;60;45;45;0
BACHARELADO EM POLÍTICAS PÚBLICAS;ESZP037-14;1;42;33;33;0
BACHARELADO EM POLÍTICAS PÚBLICAS;ESZP045-13;2;84;28;28;0
BACHARELADO EM QUÍMICA;NHT1056-15;3;60;49;46;3
BACHARELADO EM QUÍMICA;NHT4001-15;2;60;51;41;10
BACHARELADO EM QUÍMICA;NHT4002-13;2;63;62;62;0
BACHARELADO EM QUÍMICA;NHT4007-15;2;61;45;45;0
BACHARELADO EM QUÍMICA;NHT4040-15;2;60;46;46;0
BACHARELADO EM QUÍMICA;NHT4041-15;2;60;47;47;0
BACHARELADO EM QUÍMICA;NHT4046-15;1;30;8;8;0
BACHARELADO EM QUÍMICA;NHT4049-15;2;60;33;33;0
BACHARELADO EM QUÍMICA;NHT4051-15;2;60;71;56;15
BACHARELADO EM QUÍMICA;NHT4075-15;2;63;43;41;2
BACHARELADO EM QUÍMICA;NHZ4004-15;2;60;19;19;0
BACHARELADO EM QUÍMICA;NHZ4029-15;2;60;7;7;0
BACHARELADO EM QUÍMICA;NHZ4035-15;1;60;40;40;0
BACHARELADO EM QUÍMICA;NHZ4038-15;1;30;23;23;0
BACHARELADO EM QUÍMICA;NHZ4070-15;1;30;14;14;0
BACHARELADO EM RELAÇÕES INTERNACIONAIS;ESHR004-13;2;180;105;105;0
BACHARELADO EM RELAÇÕES INTERNACIONAIS;ESHR006-13;2;180;234;180;54
BACHARELADO EM RELAÇÕES INTERNACIONAIS;ESHR007-14;2;180;202;177;25
BACHARELADO EM RELAÇÕES INTERNACIONAIS;ESHR008-13;2;180;178;165;13
BACHARELADO EM RELAÇÕES INTERNACIONAIS;ESHR011-13;2;183;219;183;36
BACHARELADO EM RELAÇÕES INTERNACIONAIS;ESHR017-13;2;180;136;136;0
BACHARELADO EM RELAÇÕES INTERNACIONAIS;ESHR018-13;2;150;101;101;0
BACHARELADO EM RELAÇÕES INTERNACIONAIS;ESHR022-14;2;187;236;187;49
BACHARELADO EM RELAÇÕES INTERNACIONAIS;ESHR025-14;2;157;157;157;0
BACHARELADO EM RELAÇÕES INTERNACIONAIS;ESHR026-14;2;188;165;165;0
BACHARELADO EM RELAÇÕES INTERNACIONAIS;ESZR002-13;2;130;159;130;29
BACHARELADO EM RELAÇÕES INTERNACIONAIS;ESZR007-13;2;80;86;75;11
ENGENHARIA AEROESPACIAL;ESTI003-17;6;379;347;347;0
ENGENHARIA AEROESPACIAL;ESTS001-17;2;156;118;118;0
ENGENHARIA AEROESPACIAL;ESTS003-17;1;63;38;38;0
ENGENHARIA AEROESPACIAL;ESTS004-17;1;60;32;32;0
ENGENHARIA AEROESPACIAL;ESTS007-17;1;41;32;32;0
ENGENHARIA AEROESPACIAL;ESTS008-17;2;125;57;57;0
ENGENHARIA AEROESPACIAL;ESTS010-17;3;144;141;140;1
ENGENHARIA AEROESPACIAL;ESTS012-17;1;63;51;51;0
ENGENHARIA AEROESPACIAL;ESTS015-17;2;155;67;67;0
ENGENHARIA AEROESPACIAL;ESTS016-17;1;52;52;52;0
ENGENHARIA AEROESPACIAL;ESZS002-17;1;60;79;60;19
ENGENHARIA AEROESPACIAL;ESZS010-17;1;65;14;14;0
ENGENHARIA AEROESPACIAL;ESZS021-17;1;40;15;15;0
ENGENHARIA AEROESPACIAL;ESZS029-17;1;60;13;13;0
ENGENHARIA AEROESPACIAL;ESZS030-17;1;42;47;42;5
ENGENHARIA AMBIENTAL E URBANA;ESTU004-17;2;60;40;40;0
ENGENHARIA AMBIENTAL E URBANA;ESTU007-17;2;80;59;56;3
ENGENHARIA AMBIENTAL E URBANA;ESTU011-17;2;129;112;112;0
ENGENHARIA AMBIENTAL E URBANA;ESTU020-17;2;125;76;76;0
ENGENHARIA AMBIENTAL E URBANA;ESTU023-17;2;125;120;103;17
ENGENHARIA AMBIENTAL E URBANA;ESTU024-17;4;120;109;78;31
ENGENHARIA AMBIENTAL E URBANA;ESTU025-17;2;60;47;47;0
ENGENHARIA AMBIENTAL E URBANA;ESTU026-17;4;123;105;101;4
ENGENHARIA AMBIENTAL E URBANA;ESTU029-17;2;125;120;96;24
ENGENHARIA AMBIENTAL E URBANA;ESTU032-17;2;62;109;62;47
ENGENHARIA AMBIENTAL E URBANA;ESTU037-17;2;125;73;73;0
ENGENHARIA AMBIENTAL E URBANA;ESZU014-17;1;48;15;15;0
ENGENHARIA AMBIENTAL E URBANA;ESZU018-17;1;42;20;20;0
ENGENHARIA AMBIENTAL E URBANA;ESZU020-17;1;45;49;45;4
ENGENHARIA AMBIENTAL E URBANA;ESZU031-17;1;37;37;37;0
ENGENHARIA AMBIENTAL E URBANA;ESZU032-17;1;30;13;13;0
ENGENHARIA AMBIENTAL E URBANA;ESZU036-17;1;63;48;48;0
ENGENHARIA BIOMÉDICA;ESTB002-17;2;60;88;60;28
ENGENHARIA BIOMÉDICA;ESTB007-17;2;80;88;78;10
ENGENHARIA BIOMÉDICA;ESTB010-17;2;82;88;69;19
ENGENHARIA BIOMÉDICA;ESTB018-17;3;120;110;98;12
ENGENHARIA BIOMÉDICA;ESTB022-17;3;90;78;74;4
ENGENHARIA BIOMÉDICA;ESTB030-17;2;125;69;69;0
ENGENHARIA BIOMÉDICA;ESZB004-17;1;30;10;10;0
ENGENHARIA BIOMÉDICA;ESZB006-17;1;20;23;20;3
ENGENHARIA BIOMÉDICA;ESZB015-17;1;42;6;6;0
ENGENHARIA BIOMÉDICA;ESZB017-17;1;42;23;23;0
ENGENHARIA BIOMÉDICA;ESZB021-17;2;134;129;129;0
ENGENHARIA BIOMÉDICA;ESZB026-17;1;30;15;15;0
ENGENHARIA DE ENERGIA;ESTA004-17;2;60;39;39;0
ENGENHARIA DE ENERGIA;ESTA017-17;2;60;27;27;0
ENGENHARIA DE ENERGIA;ESTE015-17;1;66;66;66;0
ENGENHARIA DE ENERGIA;ESTE016-17;1;62;24;24;0
ENGENHARIA DE ENERGIA;ESTE017-17;1;67;48;48;0
ENGENHARIA DE ENERGIA;ESTE018-17;1;62;18;18;0
ENGENHARIA DE ENERGIA;ESTE019-17;2;60;91;60;31
ENGENHARIA DE ENERGIA;ESTE020-17;2;60;24;24;0
ENGENHARIA DE ENERGIA;ESTE021-17;1;62;32;32;0
ENGENHARIA DE ENERGIA;ESTE022-17;1;70;63;63;0
ENGENHARIA DE ENERGIA;ESTE023-17;1;62;14;14;0
ENGENHARIA DE ENERGIA;ESTE026-17;2;30;6;4;2
ENGENHARIA DE ENERGIA;ESTE027-17;2;60;41;41;0
ENGENHARIA DE ENERGIA;ESTE028-17;1;75;75;75;0
ENGENHARIA DE ENERGIA;ESTE030-17;1;62;15;15;0
ENGENHARIA DE ENERGIA;ESTE033-17;1;62;22;22;0
ENGENHARIA DE ENERGIA;ESTE034-17;1;0;6;0;6
ENGENHARIA DE ENERGIA;ESTE035-17;1;63;47;47;0
ENGENHARIA DE ENERGIA;ESTE037-17;1;70;21;21;0
ENGENHARIA DE ENERGIA;ESZA011-17;1;30;28;28;0
ENGENHARIA DE ENERGIA;ESZE038-17;1;63;7;7;0
ENGENHARIA DE ENERGIA;ESZE044-17;1;48;35;35;0
ENGENHARIA DE ENERGIA;ESZE065-17;1;63;46;46;0
ENGENHARIA DE ENERGIA;ESZE077-17;1;62;6;6;0
ENGENHARIA DE ENERGIA;ESZE099-17;1;63;4;4;0
ENGENHARIA DE ENERGIA;ESZE104-17;1;100;100;100;0
ENGENHARIA DE ENERGIA;ESZE106-17;1;63;36;36;0
ENGENHARIA DE ENERGIA;ESZE107-17;1;47;23;23;0
ENGENHARIA DE ENERGIA;ESZU035-17;1;47;44;44;0
ENGENHARIA DE GESTÃO;ESTG004-17;1;65;150;65;85
ENGENHARIA DE GESTÃO;ESTG005-17;1;65;168;65;103
ENGENHARIA DE GESTÃO;ESTG006-17;1;65;121;65;56
ENGENHARIA DE GESTÃO;ESTG007-17;1;65;100;65;35
ENGENHARIA DE GESTÃO;ESTG008-17;1;65;133;65;68
ENGENHARIA DE GESTÃO;ESTG009-17;1;65;98;65;33
ENGENHARIA DE GESTÃO;ESTG010-17;1;65;102;65;37
ENGENHARIA DE GESTÃO;ESTG011-17;1;65;142;65;77
ENGENHARIA DE GESTÃO;ESTG014-17;1;65;109;65;44
ENGENHARIA DE GESTÃO;ESTG017-17;2;64;96;64;32
ENGENHARIA DE GESTÃO;ESTG019-17;1;65;152;65;87
ENGENHARIA DE GESTÃO;ESTG020-17;2;60;181;60;121
ENGENHARIA DE GESTÃO;ESTG022-17;2;60;154;60;94
ENGENHARIA DE GESTÃO;ESTG023-17;1;65;159;65;94
ENGENHARIA DE GESTÃO;ESTG025-17;1;65;141;65;76
ENGENHARIA DE GESTÃO;ESZG007-17;1;42;61;42;19
ENGENHARIA DE GESTÃO;ESZG013-17;1;65;94;65;29
ENGENHARIA DE GESTÃO;ESZG021-17;1;65;132;65;67
ENGENHARIA DE GESTÃO;ESZG031-17;1;65;129;65;64
ENGENHARIA DE GESTÃO;ESZG036-17;1;0;119;0;119
ENGENHARIA DE GESTÃO;ESZG037-17;1;65;119;65;54
ENGENHARIA DE GESTÃO;ESZG040-17;2;84;96;84;12
ENGENHARIA DE GESTÃO;ESZG041-17;1;65;47;47;0
ENGENHARIA DE INFORMAÇÃO;ESTI005-17;2;120;58;58;0
ENGENHARIA DE INFORMAÇÃO;ESTI007-17;2;62;48;39;9
ENGENHARIA DE INFORMAÇÃO;ESTI013-17;5;122;91;80;11
ENGENHARIA DE INFORMAÇÃO;ESTI017-17;2;64;35;35;0
ENGENHARIA DE INFORMAÇÃO;ESTI019-17;2;62;44;39;5
ENGENHARIA DE INFORMAÇÃO;ESZI002-17;1;30;6;6;0
ENGENHARIA DE INFORMAÇÃO;ESZI010-17;1;32;5;5;0
ENGENHARIA DE INFORMAÇÃO;ESZI014-17;4;90;71;71;0
ENGENHARIA DE INFORMAÇÃO;ESZI028-17;1;30;15;15;0
ENGENHARIA DE INFORMAÇÃO;ESZI030-17;1;32;16;16;0
ENGENHARIA DE INFORMAÇÃO;ESZI031-17;3;60;47;45;2
ENGENHARIA DE INFORMAÇÃO;ESZI035-17;1;32;15;15;0
ENGENHARIA DE INFORMAÇÃO;ESZI036-17;1;30;5;5;0
ENGENHARIA DE INFORMAÇÃO;ESZI038-17;1;30;3;3;0
ENGENHARIA DE INFORMAÇÃO;ESZI043-17;1;32;20;20;0
ENGENHARIA DE INSTRUMENTAÇÃO, AUTOMAÇÃO E ROBÓTICA;ESTA001-17;1;31;38;31;7
ENGENHARIA DE INSTRUMENTAÇÃO, AUTOMAÇÃO E ROBÓTICA;ESTA002-17;12;305;327;246;81
ENGENHARIA DE INSTRUMENTAÇÃO, AUTOMAÇÃO E ROBÓTICA;ESTA006-17;3;93;36;36;0
ENGENHARIA DE INSTRUMENTAÇÃO, AUTOMAÇÃO E ROBÓTICA;ESTA008-17;6;206;145;143;2
ENGENHARIA DE INSTRUMENTAÇÃO, AUTOMAÇÃO E ROBÓTICA;ESTA010-17;4;120;137;77;60
ENGENHARIA DE INSTRUMENTAÇÃO, AUTOMAÇÃO E ROBÓTICA;ESTA011-17;4;124;78;78;0
ENGENHARIA DE INSTRUMENTAÇÃO, AUTOMAÇÃO E ROBÓTICA;ESTA013-17;2;40;47;39;8
ENGENHARIA DE INSTRUMENTAÇÃO, AUTOMAÇÃO E ROBÓTICA;ESTA014-17;2;64;89;64;25
ENGENHARIA DE INSTRUMENTAÇÃO, AUTOMAÇÃO E ROBÓTICA;ESTA016-17;2;163;133;133;0
ENGENHARIA DE INSTRUMENTAÇÃO, AUTOMAÇÃO E ROBÓTICA;ESTA018-17;1;54;28;28;0
ENGENHARIA DE INSTRUMENTAÇÃO, AUTOMAÇÃO E ROBÓTICA;ESTA019-17;5;152;184;152;32
ENGENHARIA DE INSTRUMENTAÇÃO, AUTOMAÇÃO E ROBÓTICA;ESTA020-17;2;125;82;82;0
ENGENHARIA DE INSTRUMENTAÇÃO, AUTOMAÇÃO E ROBÓTICA;ESTA022-17;1;62;46;46;0
ENGENHARIA DE INSTRUMENTAÇÃO, AUTOMAÇÃO E ROBÓTICA;ESTA023-17;1;30;47;30;17
ENGENHARIA DE INSTRUMENTAÇÃO, AUTOMAÇÃO E ROBÓTICA;ESTI002-17;4;61;48;41;7
ENGENHARIA DE INSTRUMENTAÇÃO, AUTOMAÇÃO E ROBÓTICA;ESZA005-17;1;30;57;30;27
ENGENHARIA DE INSTRUMENTAÇÃO, AUTOMAÇÃO E ROBÓTICA;ESZA006-17;1;54;13;13;0
ENGENHARIA DE INSTRUMENTAÇÃO, AUTOMAÇÃO E ROBÓTICA;ESZA007-17;1;60;26;26;0
ENGENHARIA DE INSTRUMENTAÇÃO, AUTOMAÇÃO E ROBÓTICA;ESZA013-17;1;31;6;6;0
ENGENHARIA DE INSTRUMENTAÇÃO, AUTOMAÇÃO E ROBÓTICA;ESZA018-17;1;31;39;31;8
ENGENHARIA DE INSTRUMENTAÇÃO, AUTOMAÇÃO E ROBÓTICA;ESZI025-17;1;30;4;4;0
ENGENHARIA DE INSTRUMENTAÇÃO, AUTOMAÇÃO E ROBÓTICA;ESTA0005-17;1;60;0;0;0
ENGENHARIA DE MATERIAIS;ESTM002-17;1;30;18;18;0
ENGENHARIA DE MATERIAIS;ESTM003-17;3;90;60;55;5
ENGENHARIA DE MATERIAIS;ESTM004-17;2;146;107;107;0
ENGENHARIA DE MATERIAIS;ESTM005-17;1;63;35;35;0
ENGENHARIA DE MATERIAIS;ESTM006-17;1;30;13;13;0
ENGENHARIA DE MATERIAIS;ESTM008-17;2;62;60;51;9
ENGENHARIA DE MATERIAIS;ESTM009-17;2;126;61;61;0
ENGENHARIA DE MATERIAIS;ESTM010-17;4;125;106;71;35
ENGENHARIA DE MATERIAIS;ESTM014-17;1;30;27;27;0
ENGENHARIA DE MATERIAIS;ESTM016-17;1;30;30;30;0
ENGENHARIA DE MATERIAIS;ESTM019-17;2;126;56;56;0
ENGENHARIA DE MATERIAIS;ESZM016-17;1;34;38;34;4
ENGENHARIA DE MATERIAIS;ESZM023-17;1;63;23;23;0
ENGENHARIA DE MATERIAIS;ESZM024-17;1;30;10;10;0
ENGENHARIA DE MATERIAIS;ESZM027-17;1;63;12;12;0
ENGENHARIA DE MATERIAIS;ESZM028-17;1;63;43;43;0
ENGENHARIA DE MATERIAIS;ESZM029-17;1;30;11;11;0
ENGENHARIA DE MATERIAIS;ESZM032-17;1;30;17;17;0
ENGENHARIA DE MATERIAIS;ESZM033-17;1;30;70;30;40
ENGENHARIA DE MATERIAIS;ESZM034-17;1;63;40;40;0
ENGENHARIA DE MATERIAIS;ESZM039-17;1;30;18;18;0
ENGENHARIA DE MATERIAIS;ESZM041-17;1;63;16;16;0
ENGENHARIAS;ESTO001-17;8;240;276;191;85
ENGENHARIAS;ESTO004-17;6;180;170;150;20
ENGENHARIAS;ESTO005-17;2;180;83;83;0
ENGENHARIAS;ESTO006-17;12;360;324;257;67
ENGENHARIAS;ESTO008-17;6;415;419;292;127
ENGENHARIAS;ESTO012-17;8;692;1033;654;379
ENGENHARIAS;ESTO013-17;11;991;718;718;0
ENGENHARIAS;ESTO015-17;1;110;105;105;0
ENGENHARIAS;ESTO016-17;6;405;357;352;5
ENGENHARIAS;ESTO017-17;4;120;225;110;115
ENGENHARIAS;ESTO902-17;15;392;542;346;196
ENGENHARIAS;ESTO903-17;25;680;647;502;145
ENGENHARIAS;MCTB001-17;9;872;683;683;0
ENGENHARIAS;MCTB009-17;6;496;427;427;0
LICENCIATURA EM CIÊNCIAS BIOLÓGICAS;NHT1084-16;2;60;16;16;0
LICENCIATURA EM CIÊNCIAS BIOLÓGICAS;NHT5013-15;4;130;89;89;0
LICENCIATURA EM CIÊNCIAS BIOLÓGICAS;NHZ1094-19;2;80;49;49;0
LICENCIATURA EM CIÊNCIAS BIOLÓGICAS;NHZ3060-15;1;30;4;4;0
LICENCIATURA EM CIÊNCIAS BIOLÓGICAS;NHZ5014-15;2;60;28;28;0
LICENCIATURA EM CIÊNCIAS BIOLÓGICAS;NHZ5021-16;2;66;103;66;37
LICENCIATURA EM FILOSOFIA;NHH2085-16;2;80;48;48;0
LICENCIATURA EM FILOSOFIA;NHH2087-16;2;80;21;21;0
LICENCIATURA EM FILOSOFIA;NHH2088-16;2;70;17;17;0
LICENCIATURA EM FILOSOFIA;NHZ2097-16;1;30;5;5;0
LICENCIATURA EM FÍSICA;NHT3013-13;2;60;25;25;0
LICENCIATURA EM FÍSICA;NHT3048-15;2;60;18;18;0
LICENCIATURA EM FÍSICA;NHT3090-15;2;60;19;19;0
LICENCIATURA EM FÍSICA;NHZ3084-15;1;40;29;29;0
LICENCIATURA EM FÍSICA;NHZ5015-09;2;100;14;14;0
LICENCIATURA EM MATEMÁTICA;MCTD010-18;1;40;29;29;0
LICENCIATURA EM MATEMÁTICA;MCTD018-18;2;60;11;11;0
LICENCIATURA EM MATEMÁTICA;MCTD020-18;1;30;17;17;0
LICENCIATURA EM MATEMÁTICA;MCTD022-18;1;35;48;35;13
LICENCIATURA EM MATEMÁTICA;MCZB036-17;1;34;34;34;0
LICENCIATURA EM MATEMÁTICA;MCZD005-18;1;38;9;9;0
LICENCIATURA EM MATEMÁTICA;MCZD007-18;1;45;10;10;0
LICENCIATURA EM MATEMÁTICA;NHZ5020-15;4;190;191;100;91
LICENCIATURA EM QUÍMICA;NHI5011-13;6;238;217;190;27
LICENCIATURA EM QUÍMICA;NHI5015-15;1;40;104;40;64
LICENCIATURA EM QUÍMICA;NHT4071-15;2;60;13;13;0
LICENCIATURA EM QUÍMICA;NHZ4074-15;1;30;12;12;0
LICENCIATURA EM QUÍMICA;NHZ5016-15;2;75;63;57;6
