disciplina;quantidade de turmas;total de vagas;qtdade. de solicitações;qtdade. de matrículas deferidas;qtdade. de matrículas indeferidas
NHT1002-15;6;328;349;328;21
NHZ1027-15;2;65;65;65;0
ESZB022-17;2;60;93;60;33
MCTA002-17;3;180;166;166;0
MCTA003-17;1;10;25;10;15
MCZA002-17;2;120;67;67;0
MCTA004-17;3;130;134;116;18
MCTA037-17;4;240;277;180;97
MCZA006-17;1;10;16;10;6
MCTA008-17;2;120;121;107;14
MCTA033-15;4;190;155;150;5
MCTA014-15;2;120;173;120;53
MCTA015-13;3;180;124;124;0
MCZA015-13;3;130;106;95;11
MCZA017-13;1;60;25;25;0
MCZA042-17;1;60;24;24;0
MCTA028-15;7;426;415;375;40
MCTA017-17;2;120;132;115;17
MCZA019-17;2;120;100;91;9
MCTA022-17;3;180;157;152;5
MCTA023-17;2;120;80;80;0
MCTA026-13;3;120;98;95;3
MCTA027-17;2;120;120;111;9
ESZA019-17;1;10;45;10;35
BIR0603-15;18;1038;554;545;9
BIL0304-15;4;90;60;37;23
BCN0407-15;4;240;216;176;40
BCK0104-15;7;350;583;350;233
NHT1053-15;4;121;72;72;0
NHT1013-15;2;60;23;23;0
NHZ1014-15;1;35;26;26;0
NHT1073-15;2;61;36;36;0
NHT1062-15;1;30;27;27;0
NHT1055-15;2;61;41;41;0
NHT1061-15;2;60;36;36;0
NHT1054-15;1;30;16;16;0
NHT1058-15;2;66;66;66;0
NHT1048-15;1;30;20;20;0
NHT1049-15;2;70;7;7;0
NHZ1051-13;1;35;28;28;0
BHO0101-15;4;360;53;25;28
BHQ0002-15;6;331;333;311;22
BHO1335-15;4;360;75;25;50
BHQ0001-15;2;100;138;100;38
BHQ0003-15;2;100;126;100;26
BHO0002-19;4;360;60;25;35
BHS0001-15;2;120;209;120;89
BHP0202-19;2;94;85;85;0
BHQ0301-15;2;110;174;110;64
ESHC002-17;2;141;205;141;64
ESHC035-17;1;30;0;0;0
ESHC036-17;4;129;108;108;0
ESHC008-17;2;176;176;176;0
ESHC034-17;2;136;136;136;0
ESHC014-17;2;139;139;139;0
ESHC038-17;2;177;177;177;0
ESHC028-17;2;155;170;155;15
ESTO013-17;5;395;365;365;0
ESHC016-17;2;127;138;127;11
ESHC017-17;2;130;130;130;0
ESHC018-17;2;164;201;164;37
ESHC019-17;2;109;109;109;0
ESHC032-17;2;110;152;110;42
ESHC031-17;2;105;92;92;0
ESHC026-17;2;150;210;150;60
NHZ2002-11;1;45;12;12;0
NHH2007-13;2;90;42;42;0
NHH2009-13;1;45;24;24;0
NHH2012-13;2;90;12;12;0
NHH2015-13;2;90;7;7;0
NHH2020-13;2;90;11;11;0
NHZ2021-11;1;45;30;30;0
NHH2033-13;2;90;24;24;0
NHH2035-13;2;90;56;56;0
NHH2038-13;2;90;14;14;0
NHZ2043-11;2;90;39;39;0
NHI2049-13;4;240;284;177;107
NHZ2051-11;1;45;7;7;0
NHH2064-13;2;90;10;10;0
NHH2073-13;2;90;12;12;0
NHZ2075-11;1;45;2;2;0
NHT3067-15;2;60;33;33;0
NHT3071-15;2;60;27;27;0
NHZ3007-15;1;30;6;6;0
NHT3012-15;2;60;46;41;5
NHZ3020-15;1;30;7;7;0
NHZ3024-15;1;30;8;8;0
NHZ3075-15;1;30;3;3;0
NHT3072-15;2;59;28;28;0
NHZ3043-15;2;60;58;43;15
NHZ3053-15;1;30;11;11;0
NHT3089-15;1;25;7;7;0
MCTB003-17;1;45;7;7;0
MCTB004-17;1;45;17;17;0
MCTB005-13;1;45;36;36;0
MCTB008-17;1;45;31;31;0
MCTB009-17;6;360;415;341;74
MCTB018-17;1;45;18;18;0
MCTB021-17;1;45;16;16;0
MCZB029-17;1;45;4;4;0
MCZB030-17;1;45;13;13;0
MCTB024-13;1;45;5;5;0
MCTB025-13;1;45;5;5;0
MCTB027-13;1;45;4;4;0
MCZC004-15;2;45;11;8;3
MCTC002-15;3;135;109;98;11
MCZC003-15;2;92;71;71;0
MCTC023-15;2;90;52;52;0
MCZC008-13;2;90;67;67;0
MCTC019-15;2;90;52;52;0
MCZC016-15;2;91;81;81;0
MCTC022-15;2;94;82;82;0
MCTC011-15;2;90;98;79;19
MCZC012-15;2;90;44;44;0
BCL0306-15;32;1524;68;68;0
ESHT025-17;2;83;62;62;0
ESHT006-17;2;120;52;52;0
ESHT008-17;2;137;120;120;0
ESTU039-17;2;90;62;62;0
ESZT015-17;1;40;35;35;0
ESTU021-17;3;225;101;101;0
ESZT016-17;2;85;66;66;0
ESHT024-17;2;76;27;27;0
ESHP005-13;2;110;208;110;98
ESHP023-14;2;106;99;99;0
ESZP044-14;2;90;74;74;0
ESHP024-14;2;90;40;40;0
ESHP016-13;4;240;241;179;62
ESHP020-13;2;92;77;77;0
ESHP029-14;2;92;77;77;0
NHZ1009-15;3;60;42;34;8
NHZ4004-15;2;30;19;19;0
NHT4006-15;2;60;23;23;0
NHT4049-15;2;60;30;30;0
NHT4017-15;2;60;48;48;0
NHT4023-15;2;30;13;9;4
NHT4024-15;2;60;24;24;0
NHZ4062-15;1;30;70;30;40
NHT4025-15;2;95;28;28;0
NHZ4028-15;2;60;25;25;0
NHZ4029-15;2;60;13;13;0
NHT3049-15;2;60;26;26;0
NHZ4064-15;1;30;12;12;0
NHT4057-15;2;60;28;28;0
NHT4055-15;2;60;25;25;0
NHT4046-15;1;30;12;12;0
ESHR001-13;3;198;197;194;3
ESHR002-13;2;132;140;130;10
ESHR003-13;4;264;235;235;0
ESHR903-18;2;90;46;46;0
ESHR023-14;2;132;173;132;41
ESHR012-13;2;180;167;159;8
ESHR028-14;2;132;163;132;31
ESHR014-13;2;132;110;110;0
ESHR019-13;2;180;257;180;77
ESTS016-17;2;83;73;73;0
ESTS002-17;1;62;62;62;0
ESZS001-17;1;58;58;58;0
ESZS002-17;1;54;54;54;0
ESZS012-17;1;40;22;22;0
ESZS004-17;1;40;11;11;0
ESTS015-17;1;40;36;36;0
ESZS034-17;1;0;3;0;3
ESZA007-17;1;73;73;73;0
ESZS035-17;1;40;9;9;0
ESTS019-17;2;80;43;43;0
ESTS005-17;1;41;41;41;0
ESTS007-17;1;43;43;43;0
ESZS003-17;1;40;16;16;0
ESTS003-17;2;80;67;59;8
ESTS006-17;2;80;89;72;17
ESTS009-17;1;40;37;37;0
ESZS018-17;1;0;1;0;1
ESTS011-17;1;40;30;30;0
ESTA020-17;5;124;99;69;30
ESZS028-17;1;40;11;11;0
ESTA003-17;4;152;100;96;4
ESTA008-17;6;211;187;161;26
ESTS017-17;1;41;41;41;0
ESZS021-17;1;40;19;19;0
ESTS010-17;2;80;67;46;21
ESTU005-17;2;80;49;49;0
ESZU002-17;2;67;67;67;0
ESZU034-17;2;80;89;72;17
ESTU027-17;2;116;38;38;0
ESZU035-17;1;40;21;21;0
ESTU007-17;1;40;30;30;0
ESTU010-17;4;124;59;59;0
ESTU012-17;2;122;72;72;0
ESZU016-17;2;80;61;50;11
ESZU023-17;2;80;64;64;0
ESTU033-17;2;80;67;57;10
ESTU015-17;2;80;91;78;13
ESTU019-17;2;123;28;28;0
ESTU038-17;1;38;38;38;0
ESTB029-17;2;81;60;60;0
ESTB004-17;2;60;36;36;0
ESTB019-17;2;64;58;58;0
ESTB022-17;2;76;76;76;0
ESZB031-17;1;44;44;44;0
ESZB007-17;1;30;6;6;0
ESZB005-17;1;30;45;30;15
ESZB021-17;2;60;47;47;0
ESTB031-18;1;40;63;40;23
ESTB020-17;2;85;73;73;0
ESTB015-17;2;130;84;84;0
ESTB009-17;2;60;51;51;0
ESTM010-17;2;94;81;81;0
ESZB016-17;1;43;43;43;0
ESZE097-17;1;45;38;38;0
ESTA004-17;5;290;176;176;0
ESTE036-17;1;45;18;18;0
ESZE105-17;1;51;51;51;0
ESTE004-17;1;45;67;45;22
ESTE034-17;1;45;29;29;0
ESTE029-17;1;45;19;19;0
ESTE030-17;1;45;24;24;0
ESTE035-17;1;45;19;19;0
ESTE028-17;1;45;26;26;0
ESTE032-17;1;47;47;47;0
ESTE015-17;1;50;42;42;0
ESTE025-17;1;45;15;15;0
ESZE109-17;1;45;37;37;0
ESTE016-17;1;45;45;45;0
ESTA016-17;3;156;70;70;0
ESTE024-17;1;60;60;60;0
ESTE017-17;1;45;21;21;0
ESZE111-17;1;45;10;10;0
ESZE100-17;1;45;16;16;0
ESZE107-17;1;45;28;28;0
ESTE022-17;1;50;66;50;16
ESTE023-17;1;50;66;50;16
ESTG001-17;2;250;166;125;41
ESTG002-17;1;125;77;77;0
ESTG003-17;2;250;350;250;100
ESTG004-17;1;125;150;125;25
ESZG013-17;1;125;90;90;0
ESTG005-17;1;125;184;125;59
ESTG006-17;1;125;154;125;29
ESTG007-17;1;125;87;87;0
ESTG011-17;1;125;174;125;49
ESZG018-17;1;62;38;38;0
ESTG008-17;1;125;174;125;49
ESZG041-17;1;125;21;21;0
ESTG009-17;2;125;75;75;0
ESTG010-17;1;125;109;109;0
ESTG017-17;1;62;79;62;17
ESTG023-17;1;125;208;125;83
ESTG013-17;1;62;94;62;32
ESTG014-17;1;125;70;70;0
ESTG025-17;1;63;86;63;23
ESTG016-17;1;125;61;61;0
ESTG022-17;1;63;54;54;0
ESTG024-17;1;125;135;125;10
ESTG020-17;1;62;86;62;24
ESTG019-17;1;125;136;125;11
ESTI010-17;2;120;42;42;0
ESTA001-17;5;160;81;80;1
ESTI002-17;1;60;42;42;0
ESZI002-17;1;60;8;8;0
ESZI030-17;1;60;12;12;0
ESZI045-17;1;60;10;10;0
ESTI018-17;1;60;53;53;0
ESTI004-17;2;120;62;62;0
ESZI043-17;1;60;28;28;0
MCTA022-13;2;120;35;35;0
ESZI031-17;1;60;11;11;0
ESZI010-17;1;60;19;19;0
ESZI014-17;1;60;15;15;0
ESTI013-17;3;134;104;104;0
ESTI008-17;2;119;47;47;0
ESTA005-17;2;153;111;96;15
ESTA011-17;3;60;31;30;1
ESTA007-17;1;43;43;43;0
ESTA006-17;2;60;15;15;0
ESTA013-17;2;68;22;22;0
ESZA023-17;1;31;74;31;43
ESTA023-17;4;120;63;63;0
ESZA016-17;2;61;44;44;0
ESTA010-17;3;90;52;31;21
ESTA014-17;5;164;66;66;0
ESZA015-17;2;60;57;57;0
ESTA022-17;2;126;78;78;0
ESTI003-17;2;120;46;46;0
ESZM035-17;1;30;59;30;29
ESZM032-17;1;31;31;31;0
ESZM036-17;1;60;60;60;0
ESTM014-17;3;66;58;55;3
ESZM022-17;1;30;24;24;0
ESZM008-17;1;30;13;13;0
ESZM007-17;1;30;4;4;0
ESZM029-17;1;30;0;0;0
ESTM001-17;2;60;21;21;0
ESTM005-17;1;34;34;34;0
ESZM027-17;1;45;59;45;14
ESZM028-17;1;30;26;26;0
ESZM023-17;1;30;17;17;0
ESZM002-17;1;50;50;50;0
ESZM037-17;1;30;19;19;0
ESTM019-17;1;32;32;32;0
ESZM033-17;2;60;49;49;0
ESTM015-17;2;73;73;73;0
ESZM025-17;1;40;40;40;0
ESZM016-17;1;44;44;44;0
ESTM018-17;1;46;46;46;0
ESTM009-17;1;52;52;52;0
ESTO001-17;8;502;359;343;16
ESTO011-17;10;395;276;276;0
ESTO004-17;2;168;168;168;0
ESTO005-17;7;420;211;211;0
ESTO006-17;10;466;303;295;8
ESTO015-17;3;200;229;110;119
ESTO008-17;3;230;342;230;112
ESTO012-17;6;630;505;505;0
ESTO014-17;4;186;202;141;61
NHI5001-15;9;317;155;150;5
NHT1086-16;1;30;8;8;0
NHT5012-15;5;150;46;46;0
NHT1085-16;1;30;9;9;0
BIS0005-15;12;470;285;258;27
BIJ0207-15;6;238;75;45;30
NHZ2044-11;2;40;8;6;2
NHZ2099-16;8;260;29;29;0
BIQ0602-15;14;816;687;665;22
NHZ5016-15;6;198;48;48;0
NHI5011-13;6;203;53;53;0
NHZ2092-16;1;30;25;25;0
NHI5002-15;6;200;101;101;0
NHH2017-16;1;30;10;10;0
NHH2089-16;2;30;7;6;1
NHI5015-15;5;150;254;150;104
NHT3037-13;1;30;15;15;0
NHZ3060-09;1;30;20;20;0
NHT3091-15;2;60;15;15;0
MCTD024-18;1;45;31;31;0
MCTD020-18;2;90;23;23;0
MCZD001-18;1;45;5;5;0
NHZ5020-15;2;96;96;96;0
MCTD023-18;2;90;24;24;0
MCTD009-18;2;90;21;21;0
MCTD010-18;2;90;29;29;0
MCZD009-18;1;45;8;8;0
MCTD007-18;1;45;5;5;0
NHZ4075-20;2;60;28;28;0
NHT5004-15;3;90;43;43;0
NHZ4077-20;1;45;45;45;0
NHT5014-18;2;60;15;15;0
NHT4032-15;2;30;13;12;1
NHZ4074-15;1;30;4;4;0
NHZ2031-11;1;0;38;38;0
BCJ0203-15;10;400;294;294;0
BCM0506-15;9;480;533;451;82
BCN0402-15;12;720;677;675;2
BCN0405-15;8;368;304;287;17
BCS0002-15;12;360;315;313;2
BHP0001-15;8;400;81;45;36
BIN0406-15;12;480;343;329;14
BIS0003-15;36;2100;562;526;36
ESHT002-17;2;76;27;27;0
ESHT014-17;2;38;21;17;4
ESTA017-17;2;60;65;30;35
ESTB027-17;2;80;57;53;4
ESTE019-17;2;60;53;53;0
ESTE020-17;2;30;19;19;0
ESTG021-17;2;125;199;125;74
ESTU004-17;2;60;23;23;0
ESTU006-17;4;126;40;40;0
ESTU025-17;2;60;40;40;0
ESTU032-17;2;66;22;22;0
ESTU037-17;2;90;73;73;0
ESTU040-17;2;61;56;45;11
MCTA001-17;5;300;340;246;94
MCTA006-17;4;240;204;204;0
MCTC014-13;4;216;214;214;0
MCTD016-18;2;60;11;11;0
MCTD019-18;2;60;14;14;0
NHZ1097-19;2;30;14;10;4
BCL0308-15;14;600;546;546;0
ESTA002-17;3;150;92;92;0
ESTO016-17;8;360;330;324;6
MCTB001-17;16;900;816;799;17
BIR0004-15;21;970;1009;842;167
ESTA019-17;4;60;48;39;9
BCK0103-15;20;1100;1036;1025;11
BCM0504-15;25;1613;201;201;0
BCJ0204-15;42;2000;579;381;198
BCN0404-15;41;2110;587;587;0
